c(376, 283, 294, 313, 459, 154, 501, 71, 153, 69, 146, 152, 223, 
314, 163, 193, 102, 360, 94, 94, 27, 375, 422, 250, 355, 415, 
139, 171, 164, 161, 404, 62, 178, 494, 199, 155, 206, 488, 474, 
256, 381, 266, 124, 128, 82, 416, 66, 451, 200, 63, 331, 432, 
483, 464, 462, 201, 391, 171, 187, 212, 105, 433, 438, 119, 474, 
391, 225, 194, 257, 63, 362, 358, 56, 479, 283, 421, 95, 145, 
294, 276, 150, 236, 458, 139, 121, 248, 412, 142, 166, 13, 43, 
80, 237, 53, 23, 454, 0, 149, 1, 445)
